111111111111111
100000000000001
1000CC000000001
10000000CC00001
1000CC00000P001
100000000000001
111111111111111