111111111111111
100000000000001
100000E00000000
10CC00000000001
100000P00000001
100000CC0000001
111111111111111