1111111111111
100P00C0001111
1000001111001
1C0CCC000E001
1C0CCC0000001
1C0CCC000C001
1C0C000CCC001
1111111111111