11111111111111111111
1P0C00C00C00C00C00C1
11111111111111111101
100C00C00C00C00C00C1
10111111111111111111
100C00C00C00C00C0001
111111111111111111C1
100C00C00C00C00C00C1
10111111111111111111
100C00C00C00C00C0001
111111111111111111C1
1EC00C00C00CCCCCC001
11111111111111111111