11111111111111111111
10000000000000000001
10000C0000000C000001
10000000000000000001
1000000CC00000000001
100000000000CC000001
100000000000CC000001
1000CC000P0000000001
100000000E0000000001
10000000000000000001
1000CC00000000000001
10000000000CCC000001
10000000000CCC000001
10000000000CCC000001
10000000000000000001
11111111111111111111