1111111111111
1C1P00C000111
1110011110011
1C0CCC000E001
1C0CCC0000001
1C0CCC000C001
1C0C000CCC001
1111111111111