111111111111111
100000000000001
100000PP0000001
10CC00000000001
100000E0000P001
100000CC0000001
111111111111111