111111111111111
100000000000001
100000E00000001
100000000000001
10000000000P001
100000000000001
111111111111111