
EA ./textures/east.xpm
NO ./textures/chest.xpm




SO ./textures/south.xpm


WE ./textures/north.xpm




F 35, 10, 40
C 1,30,0

1111111111111111111111111
1000000000110000000000001
1011000001110000000000001
10010000000000000000000011111
11111111101100000111000000001
10000000001100000111011110011
11110111111111011100000010001
11110111111111011101010010001
11000000110101011100000010001
10000000000000001100000010001
10000000000000001101010011001
11000001110101011111011111N11
11110111 1110101 101111010001
11111111 1111111 111111111111