

      NO      ./textures/north.xpm


SO      ./textures/south.xpm
       WE   ./textures/west.xpm

EA ./textures/east.xpm


F 255,200,40


C      40,40,11



11111111111111111
1000W111110000001
100001   10000001
100001   10000001
100001   10000001
10000111110011001
10000000000011001
11111111111111111