

      NO      ./textures/north.xpm


SO      ./textures/south.xpm
       WE   ./textures/west.xpm

EA ./textures/east.xpm


F 255,200,40


C      40,40,11


11111111111111111
10000000000000001
1000E111110000001
100001   10000001
100001   11111101
100001        101
100001111     101
100000001     101
111111111     111