

NO ./textures/north.xpm
SO ./textures/south.xpm
WE ./textures/west.xpm
EA ./textures/east.xpm

F 255,10,40
C 40,40,25



11111111111111111
     100000000001
1111110111000000111111
    110111000011100000111
11111001 1100S00001111
10000001110000111101
10011100000111    11
1111 11111111