

NO ./textures/north.xpm
SO ./textures/south.xpm
WE ./textures/west.xpm
EA ./textures/east.xpm

F 255,10,40
C 40,40,25



11111111111111111
11111111111111111
11000E00000000001
10000011100000001
10000011100000001
10000011100000001

10000000000011001
10000000000011001
11111111111111111
11111111111111111