

NO ./textures/north.xpm
SO ./textures/south.xpm
WE ./textures/west.xpm
EA ./textures/east.xpm

F 255,10,40
C 40,40,25
1111111111111111111111111111111111111111111111111
1000E00000000000111111111111111111111111111111111
1000001110000000111111111111111111111111111111111
1000001110000000111111111111111111111111111111111
1000000000001100111111111111111111111111111111111
1000000000001100111111111111111111111111111111111
1111111111111111111111111111111111111111111111111